{
  "ă": "ă",
  "ấ": "ấ",
  "ầ": "ầ",
  "ẩ": "ẩ",
  "ẫ": "ẫ",
  "ế": "ế",
  "ề": "ề",
  "ể": "ể",
  "ễ": "ễ",
  "ố": "ố",
  "ồ": "ồ",
  "ổ": "ổ",
  "ỗ": "ỗ",
  "ơ": "ơ",
  "ư": "ư"
}
