{
  "♪": "",
  "ă": "ă",
  "ấ": "ấ",
  "ầ": "ầ",
  "ẩ": "ẩ",
  "ẫ": "ẫ",
  "ậ": "ậ",
  "ế": "ế",
  "ề": "ề",
  "ể": "ể",
  "ễ": "ễ",
  "ệ": "ệ",
  "ố": "ố",
  "ồ": "ồ",
  "ổ": "ổ",
  "ỗ": "ỗ",
  "ộ": "ộ",
  "ơ": "ơ",
  "ư": "ư"
}
